___________
___________
___________
____---____
___-~~~-___
___-~=~-___
___-~~~-___
____---____
___________
___________